111111
1C00E1
101101
1P0111
111111