111111111111
1000010000C1
1C0001000001
1P000000C001
111111111111