111111111
1C00E01C1
100000001
1P01110C1
111111111