111111
1000E1
101101
1P0111
111111