111111111111111
1000011000C0001
100100001000011
10000P111000000
11111111001C001
1E0000000000001
111111111111111