111111111111111
1000011000C0001
100100001000011
00000P111000001
11111111001C001
1E0000000000001
111111111111111