111111111111111
1000011000C0001
100100001000011
10000P111000001
11111111001C001
1E00000000001
111111111111111